                                      ####
                                      #  #   
                                      #  #
                                      #  #
             ##########################  #
             #                           #                #################
             #                           #               ##               #
             ##########################  #              ##                #
                                      #  #             ##   ####  ####  ###
                                      #  #         #####   ##  #  #  #  #
                                      #  #         #      ##   #  #  #  #
                                      #  #         #     ##    #  #  #  #
                                      #  #         #  ####     #  #  #  #
                                      #  #         #  #        ####  ####
                                      #  #         #  #
                                      #  ###########  #
                                      #               #
                                      #               #      
                                      #  ########  ####
                                      #  #      #   ######
                                      #  #      ##       #
                                      #  #       ##      #
                                      #  #        ########       
                                      #  #
                                      #  #
        ###############################  #
        #                                #
        #                                #
        #######  #############  #######  #
              #  #           #  #     #  #
             ##  #           #  #     #  #
             #   #           #  #     #  #
             #  ##           #  #     #  #
   ###########  ##############  #######  # 
   #                                     #
   #                                     #
   ###########  ##############  #######  #
             #  #            #  #     #  #
             #  ##          ##  #     #  #
             #   #          #   #     #  #
             ##  #          #  ##     #  #
           ####  ############  ########  #########
           #                                     #
           #                                     #
           #  #################  #######  ########              
           #  #               #  #     #  #       
           #  #               #  #     #  #       ####
############  #               #  ##### #  #########  #   
#             #               #      # #             #
#             #               #      # #             #
############  #               #  ##### #  #########  #        
           #  #               #  #     #  #       ####
           #  #               #  #     #  #       
           #  #################  #######  ############
           #                                         #
           #                                         #
           ####  ###########  ########################
              #  #         #  #
              #  #         #  #
              #  #         #  #
              #  #         #  #
              #  #         #  #
              #  ###########  #
              #               #
              #               #    
              #################

goal i 39,1
box a 16,5
goal h 29,5
goal z 73,7
agent 0 39,8
goal f 56,11
box e 70,12
box f 71,12
box d 45,16
goal e 55,21
box b 23,26
goal d 31,26
box z 9,27
goal k 16,31
box w 6,34
box c 21,34
box h 36,34
goal c 30,36
goal x 39,36
box i 39,39
box x 12,42
goal l 19,42
goal m 33,42
goal b 36,43
goal w 47,43
box k 36,48
box u 2,49
box v 4,49
goal a 35,49
goal u 45,49
box l 52,50
box t 17,54
goal s 26,54
goal t 27,54
goal n 34,54
box s 17,55
goal v 46,55
box m 49,55
box n 50,55
box o 51,55
goal o 16,58
goal p 16,59
box p 28,60
box r 15,63
goal r 26,64
