############
#        # #
# ######## #
#          #
# ######## #
# #        #
############

agent 0 8,1
goal a 10,1
box a 10,2
box b 1,4
box c 10,4
goal b 1,5
goal c 3,5
