###################
#    #            #
#    #   ######   #
#    #   #    #   #
#          ## #   #
# ######## #      #
#          #      #
######     #      #
#                 #
###################