#############
#           #
#           #
# ######### #
#           #
# ######### #
#  # # # #  #
#  # # # #  #
#  # # # #  #
#           #
#############

agent 0 1,1
goal a 4,6
goal a 6,6
goal a 8,6
box A 5,2
box A 6,2
box A 7,2