#############
#           #
# ######### #
#           #
#############

agent 0 4,1
box a 10,1
goal a 11,1
