########################
#                      #
#                      #
#                      #
#                      #
#        ###           #
#       ##   ###########
##############

agent 0 1,2
box a 2,2
goal a 3,2
goal a 10,6
box a 11,6
box a 12,6
